1 13 31
###############################
#p     ** *  1 * 2 *  * * *   #
# # # #*# # #*#*# s # #*#*#*# #
#  x*     ***  *  *   * 4 * * #
# # b # # #*# # #*#*# #*# # #*#
#f           **  *  *   * *   #
# # # # # # # # # #*# #*#*# # #
#*  *      *  *   *  *        #
# # # # #*# # # #* *# # # # # #
#*    **  *       *           #
# #*# # # # # # #*# # # # # # #
#           *   *  *          #
###############################