1 13 31
###############################
#p     ** *  1 * 1 *  * * *   #
# # # #*#d# #*#*# s # #*#*#*# #
#  x*     ***  *  *   * 1 * * #
# # b # # #*# # #*#*# #*# # #*#
#f         x **  *  *   * *   #
# # # # # # # # # #*# #*#*# # #
#*  *      *  *   *  *        #
# # # # #*# # # #*k*# #m# # # #
#*    **  *       *           #
# #*# # # # # # #*# # # # # # #
#           *   *  *          #
###############################