1 13 31
###############################
#p     ** *  1 * 2 *  * * *   #
# # # #*#4# #*#*# s # #*#*#*# #
#  x*     ***  *  *   * 2 * * #
# # b # # #*# # #*#*# #*# # #*#
#f         x **  *  *   * *   #
# # # # # # # # # #*# #*#*# # #
#*  *      *  *   *  *        #
# # # # #*# # # #*3*# #m# # # #
#*    **  *       *           #
# #*# # # # # # #*# # # # # # #
#           *   *  *          #
###############################