4 13 31
###############################
#p    * **    *               #
# # # #*# # # # # # # # # # # #
#      ** * *  *   * **   *   #
# # # # # #*# # # # #5# #*# # #
#*   * *    *b* *   **        #
# # # # # # # # # # # # # #*# #
#    *     *        *    **   #
# #*# # #*#*#*#*# # #1# # #*# #
#        *   * *    *   *     #
#*# # # # # # # # # # #*# # #*#
#x*    * **    ** ***         #
###############################